####################
   #     #      ####
## # ### # #### #  #
##   ###   ##   ## #
############# # #  #
#   #      ## # # ##
# # # ## #    #   ##
# #   ## ###########
# ######     ##   ##
#    ####### ## # ##
## ###    ## ## #  #
## ##  ## ##    ## #
##    ### ######## #
######### ###      #
#     ###  #########
# ###   ## #     ###
# ##### ##   ### ###
#    ########### ###
#### #####       ###
########## #########